╔═══╦═══╦═══╦════╦═══╦═══╦═══╗
║E  ║ . ║   ║ .  ║   ║ . ║   ║
║ .     ║        ║       ║ . ║
║   ║   ║.  ║    ║ . ║   ║   ║
╠═══╬═ ═╬═ ═╬══ ═╬═ ═╬═══╬═ ═╣
║   ║.  ║   ║  . ║   ║.  ║   ║
║ .         ║            ║ . ║
║   ║   ║ . ║    ║ . ║   ║   ║
╠═ ═╬═ ═╬═══╬════╬═ ═╬═ ═╬═ ═╣
║.  ║   ║   ║    ║   ║   ║  .║
║   ║   ║    .     . ║       ║
║   ║.  ║.  ║    ║   ║ . ║   ║
╠═ ═╬═══╬═══╬═  ═╬═══╬═══╬═══╣
║  .║   ║   ║    ║   ║ . ║   ║
║   ║    .  ║   .          . ║
║   ║.      ║                ║
║   ║   ║   ║    ║ . ║   ║   ║
╠═══╬═ ═╬═ ═╬════╬═══╬═ ═╬═══╣
║   ║ . ║   ║ .  ║   ║ . ║   ║
║ .     ║        ║   ║   ║   ║
║   ║   ║ . ║    ║  .║   ║  .║
╠═══╬═══╬═ ═╬═  ═╬═ ═╬═ ═╬═ ═╣
║ . ║.  ║   ║    ║.  ║   ║.  ║
║       ║ . ║            ║   ║
║   ║   ║   ║ .  ║   ║ . ║   ║
╠═ ═╬═══╬═ ═╬═  ═╬═ ═╬═══╬═ ═╣
║   ║  .║   ║    ║   ║ . ║   ║
║           ║ .  ║           ║
║.  ║   ║  .║    ║.  ║   ║  ■║
╚═══╩═══╩═══╩════╩═══╩═══╩═══╝